***********
* *   *   *
* * * *** *
*   *   * *
* ***** * *
*S*     * *
*** ***** *
*   *     *
* *** *** *
*     *M  *
***********